11111111111
100P0010001
11111011101
100010C0001
10101111101
101000C0001
11101110101
10001000101
10111111101
10000010001
11111111111
