11111111111
10000P1C001
11111011100
10001000000
10101111101
1C100000001
11101110101
10001C00101
10111111101
10000E10001
11111111111