11111111111
10000P1C001
11111011101
10001000001
10101111101
1C100000R01
11101110101
10001C00101
10111111101
10000E10001
11111111111