11111111111111111111111111111111111111
1000001C00110000010000111001C000000001
10111001100111000C01100000000000000001
10000100001000111010110010100000000001
101101C01000000C0000100110100000000001
100100101111111111101C1000010000000001
10C100000010C0100010110011000000000001
101100111100001E100C010010011000000001
1000100100001111111001001000C000000001
101001010101100P1001110110100000000001
10110001010100111C00010100111000000001
1110101101010100001001010010C000000001
11000010000101011010110000100000000001
11000010110100010010000010000000000001
10C00000C10001000010011111011000000001
10C00000C10001000010011111011000000001
10C00000C10001000010011111011000000001
10C00000C10001000010011111011000000001
10C00000C10001000010011111011000000001
11111111111111111111111111111111111111
