111111111111111
1000001P0000001
101110101011101
10001C001010001
111011101010111
1X000C10101C001
101110101111101
1010001010X0101
101010111010101
101010100C10101
101011101110101
101000001000101
101111111011101
1C00X01E001C001
111111111111111
