11111111111111111111111111111
10100001C0000000010C001000011
10000101101110010100001110111
1011110100001001C1C00C0011101
10000101000011000111011000101
10100001011111111100010010X01
10111001000000000100010110001
1010CC01111111110110110100111
10101000000000010010100100101
10111111000100010X101011E0101
100X000111110101000010C111111
1C0010010C01C101010111111C001
1111100110P101011100C00000011
100C0000000001000001100010011
11111111111111111111111111111
