11111111111111111111111111111
1C000000000000X000000000000E1
10010101C10101010101010101111
10000000000000000000000000001
10010101010101010101010101001
1000X000000000000000000X00001
1C01010101010101C101010101001
1000000C000000000000000000C01
1001010101C101010101010101001
100X0000000000C00000000X00001
10010101010101010101010101001
1000C0000000000000000000C0001
10010101010101010101010101001
1P000000000000X00C00000000001
11111111111111111111111111111
