1111111111111111111
1C000000000000X00E1
10010101C1010101111
1000000000000000001
1001010101010101001
1000X00000000000001
1C01010101010101001
1000C00000000000001
1001010101010101001
1P000000000000X0001
1111111111111111111
